WE ./text/path_to_the_west_texture.xpm    
      F      255, 255, 255

      C        222, 200, 100
EA        ./text/path_to_the_east_texture.xpm      

NO                      ./text/path_to_the_north_texture.xpm

SO      ./text/path_to_the_south_texture.xpm

111111111111111111111111111111111111111111111
100000000000000111111100000000000000000000011
100000001111100111111100000011111000000000011
100000001110000001111101111111111001001001011
100000001111100001111101111111111000000000011
111000111110000000000000000000111000000000011
100000001111000001111101111110111101111111111
100000001100000001111101111110111101111111111
100000000000001111111101111110000001111111111
100000000000000000000001111110111101111111111
1000000E0000000000000001111100000000000001111
100000000000000000000011111100000000000001111
111111111111111111111111111111111111111111111