WE ./path_to_the_west_texture.xpm    
      F      255, 255, 255

      C        222, 200, 100
EA        ./path_to_the_east_texture.xpm      

NO                      ./image.xpm

SO      ./path_to_the_south_texture.xpm

111111111111111111111111111111111111111111111
1000000000000000000000000S0000000000000000001
111111111111111111111111111111111111111111111